NO ./img/l.xpm
SO ./img/c.xpm
WE ./img/j.xpm
EA ./img/w.xpm

C 153, 204, 255
F 123, 20, 10

        1111111111111111111111111
        1000000000110000000000001
        1011000001110000000000001
        1001000000000000000000001
111111111011000001110000000000001
100000000011000001110111111111111
1111011111111101110000001W001
11110111111111011101010010001
11000000110101011100000010001
10000000000000001100000010001
10000000000000000001010000001
11000001110101011111011110001
11110111 1110101 101111010001
11111111 1111111 111111111111
11111111 1111111 111111111111